111111111111
1P0000010001
100011001001
1000C0001001
100001100C01
101000010001
10000C00E001
111111111111