11111111111111111111111111111
1P000010001000H00100001000001
10011101001100111001100010001
100000H0010010000010001000C01
10100111010010111010001110001
100C0000010001000000H01000001
100001000111000010011100C0001
10010100000H01000100000100001
10100001110001000101100010001
100000000010000C0001000H00101
10011100101011101001011100001
10000000100000100000001000001
100C00100001000100C00001E0001
11111111111111111111111111111