111111111111
1P0000010001
1000110H1001
1000C0001001
100001100C01
101000010001
10000C0HEH01
111111111111