NO ./textures/compass/north.png
SO ./textures/compass/south.png
WE ./textures/compass/west.png
EA ./textures/compass/east.png

F 15,24,38
C 84,19,37

11111111111111111111111
10000000000000000000001
10100000000000000010001
10100010000000000000001
10000000000N00000010001
10000000000010001000001
10001000000000001000011
100000000000000010001
111111111111111111111