NO ./textures/backrooms/backrooms.png
SO ./textures/backrooms/backrooms.png
WE ./textures/backrooms/backrooms.png
EA ./textures/backrooms/backrooms.png
DC ./textures/backrooms/backrooms_door_close.png
DO ./textures/backrooms/backrooms_door_open.png

F 49,48,27
C 49,48,27

111111111111111111111111111111
100000000010000000000000000001
10111110101011101D111011111101
100000101000001000001000000001
111110101111101011101011111101
100010100000001010001010000001
101010111111101010111010111101
10D000000000100010000010000001
101111111110101111111010111101
100000000010100000001000100001
111011111010111111101110101101
100010001000000000100000100001
101110101111111110111111101101
1000001000000000D0000000000011
101111111011111011111011111101
100000001000001000001000000001
111111101111101111101111111101
100000000000100000000000000001
101111111110111111111110111101
1000000000000000000000000N0001
111111111111111111111111111111