111111111111111111111111111111
1P010C001001010010010001000001
101000100100011001001000100001
100010001001000001010001C01001
100000C00100011000100010010001
1000100010100010000C0000010C01
10000C000010000100100001E00001
100001001000010001010001010001
100010000100001001000010000001
1000000000C0100010001000C01001
100001000100000001010001000001
10000CC00001000100001000100001
10000000C01000010000000C000001
100010010001000010001000100001
100001000100001001010001000001
111111111111111111111111111111