111111111111111111111111111111111
1P0000010000000110000000100000001
100011101110001001110001001110001
100000000001001000010000100001001
101001110001001110010111100C01001
100C00001000010000000010000000001
101001000111000010011100110001001
100001000000010001000001000001C01
100101011100010001011000100001001
101000000010000C00010000001000001
100111101010111010010111000010001
100000001000001000000010000011001
100C00100001000100C00001000000001
100011100100111000111001110001001
100000000000000C00000000000100001
101011001110001001110001001110001
10000000001000100000001000000E001
111111111111111111111111111111111