1111111111111
1CC1CCCCCCCC1
1CCCC11111CC1
1CCCC1ECCCCC1
1PCC11CCCCCC1
1CCC1CCCCCCC1
1CCCC1CCCCCC1
1CCCCCCCCCCC1
1111111111111