111111111111111111
1P0001000000100001
100011001110010C01
100000010000110001
101001000C00100001
100001110010001001
100C00000010100C01
100001010000011001
10000100000C000E01
111111111111111111