1111111111111
1C010000000C1
1000011111001
100001E000001
1P00110000001
1000100000001
1000010000001
10000000C0001
1111111111111